1984 and Animal Farm| George Orwell | 41 | /u/uiandgame
The Hitchhiker's Guide to the Galaxy | Douglas N. Adams | 39 | /u/Paranoid__Android
India After Gandhi | Ramachandra Guha | 25 | /u/lovedei
Kamasutra| vatsayayna |17 | /u/oktata
A Song Of Ice and Fire | George R R Martin | 16 | /u/SparxNet
Shantaram | Gregory Roberts | 13 | /u/agentbigman
Brave new world |  Aldous Huxley | 12 | /u/oktata
Lord Of The Rings |  J R R Tolkien | 11 | /u/SparxNet
Catch 22 | Joseph Heller | 11| /u/neatshotsoflife     
The Kite runner |Khaled Hosseini| 10 |/u/oktata
The White Tiger | Aravind Adiga | 10 | /u/Magodo
I, Asimov| Isaac Asimov| 9| /u/oktata
The catcher in the rye | J.D Salinger| 9 | /u/oktata
Art of war | Sun Tzu | 8| /u/oktata 
The discovery of India  | Nehru | 8 | /u/eldaisfish
The annihilation of caste | Ambedkar | 7 | /u/oktata
A Suitable boy | Vikram Seth| 7 | /u/oktata
Dune | Frank Herbert | 7 | /u/oktata
Surely You're Joking, Mr. Feynman! |Ralph Leighton, Richard Feynman | 6 | /u/Unnamedentity
Ponniyin selvan (Tamil) | Kalki Krishnamurthy | 6 | /u/Unnamedentity
Phantom Tollbooth |  Norton Juster | 6 | /u/Unnamedentity
Crime and Punishment |  Fyodor Dostoyevsky | 6 | /u/CrassCacophony
Jurassic Park | Michael Crichton | 5 | /u/SparxNet
Gödel, Escher, Bach: an Eternal Golden Braid | Douglas Hofstadter | 5 | /u/allamacalledcarl
One Hundred Years of Solitude | Gabriel García Márquez | 5 | /u/allamacalledcarl
The Unbearable Lightness of Being |  Milan Kundera | 5 | /u/allamacalledcarl
An Unequal Music | Vikram Seth | 5 | /u/allamacalledcarl
The Handmaid's Tale | Margaret Atwood | 5 | /u/allamacalledcarl
Complete adventures of Feluda | Satyajit Ray| 5 | /u/oktata
The Hunt For Red October | Tom Clancy | 5 | /u/SparxNet
Kane and Abel series | Jeffrey Archer| 4 | /u/SparxNet
First Among Equals | Jeffrey Archer | 4 | /u/SparxNet
Fahrenheit 451 | Ray Bradbury | 4 | /u/doc_two_thirty 
Jaya: Illustrated retelling of Mahabharata | Devdutt Pattanaik  | 4 | /u/SupremeLeaderOrnob
The design of everyday things |Don Norman | 4 | /u/oktata
The Picture of Dorian Gray|  Oscar Wilde | 4 | /u/BoomShankaram
The discovery of India | Nehru | 4 | /u/Arjun_
Indian Philosophy  |  Radhakrishnan | 4 | /u/Arjun_
Invention by Design: How Engineers Get from Thought to Thing  |  Henry Petroski | 4| /u/Arjun_
The Feynman Lectures on Physics  | Richard Feynman | 4 | /u/Arjun_
Urvashi  | Ramdhari Singh Dinkar | 4 | /u/Arjun_
My Experiments with Truth | Gandhi | 4 | /u/agentbigman
Legion | Brandon Sanderson| 4 | /u/bagofthoughts
And the Mountains Echoed | Khaled Hosseini | 4 | /u/bagofthoughts
Norwegian Wood |  Haruki Murakami  | 4 | /u/bagofthoughts
Life of Pi | Yann Martel | 4 | /u/bagofthoughts
The Great Gatsby | F. Scott Fitzgerald | 4 | /u/bagofthoughts
Twenty Thousand Leagues Under the Sea | Jules Verne | 4 | /u/bagofthoughts
Far from the Madding Crowd| Thomas Hardy | 4 | /u/bagofthoughts
Great Expectations |Charles Dickens | 4 | /u/bagofthoughts
The Count of Monte Cristo | Alexandre Dumas  | 4| /u/bagofthoughts
The Autobiography of Malcolm X  | Malcolm X | 4 | /u/bagofthoughts
No god but God: The Origins, Evolution, and Future of Islam |  Reza Aslan | 4 | /u/bagofthoughts
The Five People You Meet in Heaven | Mitch Albom | 4 | /u/bagofthoughts
The Diary of a Young Girl  | Anne Frank | 4 | /u/bagofthoughts
Man's Search for Meaning| Viktor Frankl| 4 | /u/bagofthoughts
Siddhartha | Hermann Hesse | 4 | /u/bagofthoughts
Zen and the Art of Motorcycle Maintenance | Robert M. Pirsig | 4 | /u/bagofthoughts
Buddha in Blue Jeans: An Extremely Short Zen Guide to Sitting Quietly and Being Buddha | Tai Sheridan| 4 | /u/bagofthoughts
The Prophet | kahlil gibran | 4 | /u/bagofthoughts
Rework: Change the Way You Work Forever| David Heinemeier Hansson and Jason Fried | 4 | /u/bagofthoughts
Structure and Interpretation of Computer Programs |Gerald Jay Sussman, Hal Abelson | 4 | /u/bagofthoughts
On Lisp |  Paul Graham | 4 | /u/bagofthoughts
The Joy of Clojure: Thinking the Clojure Way | Michael Fogus and Chris Houser  | 4|  /u/bagofthoughts
Computer System Architecture | M. Morris Mano | 4 |  /u/bagofthoughts
Neuromancer | William Gibson | 4 |/u/cdasx
Slaughterhouse 5 | Kurt Vonnegut | 4 | /u/cdasx
The Martian | Andy Weir | 4 | /u/badassindian
Tamas | Bhishma Sahani | 4 | /u/querria
Rag Darbari | Sri Lal Sukla | 4 | /u/querria
Kasap | Manohar Shyam Joshi  | 4 | /u/querria
Feast of the Goat| Mario Vargas Llosa | 4 | /u/querria
Love in the Time of Cholera |  G G Marquez | 4 | /u/querria
Why National Fail | Daren Acemoglu and James A. Robinson | 4 | /u/querria
A Short History of Nearly Everything | Bill Bryson | 4 |/u/dhavalcoholic
The communist manifesto | karl marx and friedrich engels | 4 | /u/IBrowseCFC
Infinite Jest | David Foster Wallace | 4 | /u/neatshotsoflife
Cosmos | Carl Sagan | 4 | /u/mujerdeindia
The Fourth Estate | Jeffrey Archer | 3 |/u/SparxNet
Things fall apart | Chinua Achebe | 3 | /u/theguywhoknewtoomuch
The long walk | Stephen King | 3 | /u/theguywhoknewtoomuch
Field Marshal Sam Manekshaw - Soldiering With Dignity | Lt. Gen. Depinder Singh | 3 | /u/SparxNet
Bhagwat Gita | Vedvyasa | 3 | /u/oktata
Arthshastra | kautilya | 3 | /u/oktata
Room |  Emma Donohue  | 3 | /u/allamacalledcarl
Godan | Premchand | 3 | /u/oktata
Why I am an atheist | Bhagat Singh | 3 | /u/oktata
The motorcycle diaries |  che geuvara | 3 | /u/oktata
Millennium series | Stieg Larsson | 3 | /u/S1VA
The Kingkiller chronicles | Patrick Rothfuss | 3 | /u/S1VA
Stephanie Plum series | Janet Evanovich  | 3 | /u/S1VA
Godfather | Mario Puzo | 3 | /u/S1VA
Ain't She Sweet | Susan Elizabeth Phillips | 3 | /u/S1VA
Sophie Kinsella Collection | Sophie Kinsella | 3 | /u/S1VA
Bet Me | Jennifer Crusie | 3 | /u/S1VA
All Creatures Great and Small    | James Herriot | 3| /u/SparxNet 
All Things Bright and Beautiful    | James Herriot | 3| /u/SparxNet
All Things Wise and Wonderful    | James Herriot | 3| /u/SparxNet
The Lord God Made Them All    | James Herriot | 3| /u/SparxNet
The Illustrated Man|Ray Bradbury | 3 | /u/saale_bhenchod
The Old Man and the Sea |  Ernest Hemingway | 3 | /u/saale_bhenchod
The Last Lecture | Randy Pausch, Jeffrey Zaslow | 3 | /u/saale_bhenchod
Jane Eyre | Charlotte Brontë | 3 | /u/saale_bhenchod
To Kill a Mockingbird | Harper Lee | 3 | /u/saale_bhenchodt
And Then There Were None | Agatha Christie | 3 | /u/saale_bhenchod
Wheel of Time | Robert Jordan |3 | /u/holdfast26
Not a penny more, not a penny less| Jeffrey Archer | 3 | /u/SparxNet
Don Quixote | Miguel de Cervantes | 3 | /u/don_quicksort
Patriots and Partisans | RC Guha | 3 | /u/mohanbhagwat
The Last mughal |Dalrymple | 3 | /u/oktata
The selfish gene | Richard dawkins | 3 | /u/oktata
His Dark Materials  | Phillip Pullman | 3| /u/allamacalledcarl
Palace of illusions  | Chitra Banerjee Divakaruni | 3 | /u/aparash
God of small things | Arundhati Roy | 3 | /u/aparash
Behind the beautiful forevers | Katherine Boo | 3 | /u/aparash
Nine Lives | William Dalrymple | 3 | /u/aparash
23 Things They Don't Tell You About Capitalism | Ha-Joon Chang  | 3 | /u/oasfox
Bad Samaritans: The Myth of Free Trade and the Secret History of Capitalism  | Ha-Joon Chang  |  3 | /u/oasfox
Capital in the Twenty-First Century | Piketty |  3 | /u/oasfox
Civilization: The Six Killer Apps of Western Power | Niall Ferguson |  3 | /u/oasfox
The Ascent of Money: A Financial History of the World | Niall Ferguson |  3 | /u/oasfox
Manufacturing Consent: The Political Economy of the Mass Media| Chomsky  |  3 | /u/oasfox
The Language Instinct: How the Mind Creates Language| Pinker |  3 | /u/oasfox
The Stuff of Thought: Language as a Window into Human Nature | Pinker |  3 | /u/oasfox
Homage to Catalonia | George Orwell | 3 | /u/metal-Music
For Whom the Bell tolls | Ernest Hemingway | 3 | /u/metal-Music
Train to Pakistan | Khushwant Singh | 3 | /u/metal-Music
The Company of Women | Khushwant Singh | 3 | /u/metal-Music
निर्मला | प्रेमचंद  | 3 | /u/metal-Music
लघु कथाएं| प्रेमचंद  | 3 | /u/metal-Music
कृष्णकली | shivaani | 3 | /u/metal-Music
शमशान चंपा | shivaani | 3 | /u/metal-Music
Mystics and Mistakes |Sadhguru Jaggi Vasudev | 3 | /u/svayam--bhagavan
Kafka  on the Shore  | Haruki Murakami |3 | /u/allamacalledcarl
The complete Sherlock Holmes  | Sir Arthur Conan Doyle  | 3 | /u/Lord_Snowy
2001: A Space Odyssey | Arthur C. Clarke | 3 | /u/MatCauthon28
Rendezvous with Rama| Arthur C. Clarke | 3 | /u/MatCauthon28
Sandman | Neil Gaiman |2 | /u/The-Mitr
Lord of the Flies | William Golding| 2 | /u/The_0bserver